NO textures/blue.xpm
SO textures/brick.xpm
EA textures/wood.xpm
WE textures/grey.xpm

C 51,153,255
F 34,139,34


11111111111111111111111111
100000000011N0000000000011111
10110000000110000000000011
10010000000000001000000011111111111
1111011111100101110000001111
11110111100001101110101001
111101111000011011101010011111111111111111
11110111100001101110101001
11110111100001101110101001111
111101111000011011101010011
11110111100001101110101001
1111011110000110111010100111
11110111100001101110101001
11111111111111111111111111
    1111111111111111111111